apologizer,num_sorrys,num_real_sorrys,num_apologies,num_good_apologies,num_bad_apologies,good_apology_rate
Monica Garcia,25,10,9,6,3,0.667
Angie H,9,5,3,2,1,0.667
Heather Gay,107,38,21,13,8,0.619
Jen Shah,124,49,26,13,13,0.500
Whitney Rose,83,30,21,10,11,0.476
Meredith Marks,90,19,15,7,8,0.467
Angie Katsanevas,50,6,5,2,3,0.400
Jennie Nguyen,17,3,3,1,2,0.333
Lisa Barlow,151,63,33,7,26,0.212
Mary Cosby,53,13,14,2,12,0.143
Bronwyn Newport,25,3,2,0,2,0.000